1111
1001
1001
1P01
10C1
1E01
1111
