1111111111
100100CL11
1001100L01
10P0E0CE01
10C1011101
1E010E0101
1111111111
