1111111111
100100C011
1001100001
10P000CE01
10C1011101
1E010E0101
1111111111
