1111
1001
1001
1PL1
10C1
1E01
1111
